111111111111111111
100100000000P01001
100000C00000010C01
10C0000000C0000001
10000000000000C001
10C00C000000000001
100001000C000C0001
1000110100000001E1
111111111111111111