111111111111111111
111111011100P01111
101100000000001C11
10C100CC0CC0001001
10010C11C11C001C01
10C100C111C0000001
1000010C1C000C0101
1C001100C00C0011E1
111111111111111111