1111111111111
100100C0000C1
1C00011111001
1E0011E0000P1
1111111111111