1111111111111111111
1000A000C0000001111
10010111110K0001111
10010B00C0000P01111
1001000D000J0001111
100E1111101100000C1
1111111111111111111