11111111111111111111111
11100C00000000011100C01
111100C00001001C0C10001
11C1110000110000C0100C1
1E0000000011C0000100001
111111110C011100100C001
11100CC00000C10010C0101
10C0C011000CC1001000111
11011100C0111100C00C011
11P00000000C000010C1111
11111111111111111111111