111111111
1C0C0C0C1
10C0P0C01
1C0C0C0E1
111111111