11111111111
1P000000001
10000000011
1000000E011
11111111111