111111111111
100C00000001
100CCC001101
10C0CCCE1101
111111111111