111111111
1P0C0000001
100CCC0011
10C0CCCE1
111111111