1111111111111111111111
10000000C0000001111001
1001011111000001111001
10010000C0000P01111111
10010000000000011110E1
10001111101100000C1001
1111111111111111111111