111111111111111111111111111111
1E0000000000000C00000C00000001
101001000000101001000000010101
1010010010100010010000C0010101
1P000C00C0000000000000000000C1
111111111111111000111111111111