1111111111111
1P0000C0C0CE1
1111111111111